16 16
0000000000000000
0111111111111110
0121221222222210
0122222242222210
0122242222242210
0123232223222210
0122122125222210
0122242222422210
0122122332222210
0121122221222210
0122222323232210
0122444212122210
0122212212222210
0122222222122210
0111111111111110
0000000000000000